12
16
____________
____#_______
____#_______
____#_______
_*__#___*___
###_#_______
____#_______
_####_#_____
____#_#_____
_*__#_#_____
____#_#_____
###_#_#_____
____#_#_____
_*____#_*___
______#_____
____@_#_____
