20
15
_________________@__
###########__#______
_____________#______
_#___________#______
_#___________#______
_#___________#______
_#___________#______
_#__________________
*#_____#######______
##___________######_
____######___#______
_#__#________#_#####
_#____#_____________
_#__################
___________________*

